x,o1D,x,x,x,x,x,x,x,x
x,o2D,x,x,x,x,x,x,x,x
x,o3D,x,o7R,o8R,o8D,x,x,x,x
x,o4R,o5R,o7R,o8R,o10D,x,x,x,x
x,o4R,o5R,o6U,x,o11D,x,x,x,x
x,x,x,x,x,o12D,x,x,x,x
x,x,x,o15D,o14L,o13L,x,x,x,x
x,x,x,o16D,o14L,o13L,x,x,x,x
x,x,x,o17D,x,x,x,x,x,x
x,x,x,o18D,x,x,x,x,x,x
